. T . X . . .
. . . . . T X
X . . T . . .
T . X . . . .
. . . . X . T
X . T . . . .
. . X . T . .